MMMMMMMMMM
M M      M
M   M    M
M  M     M
MMMMMMMMMM